16
12
00 00 12 06 06 06 06 06 06 06 06 06 11 03 03 12
00 00 03 12 06 06 06 06 06 06 13 13 14 03 03 03
01 03 03 03 12 06 06 06 06 14 03 03 03 03 15 03
09 03 15 02 03 12 13 13 14 03 03 02 03 03 03 03
11 01 01 15 03 01 01 01 01 01 07 08 09 01 01 01
11 01 01 03 03 15 01 04 04 01 10 06 11 01 15 01
11 01 01 15 03 03 01 04 04 01 12 13 14 01 01 01
14 01 01 03 03 05 01 01 01 01 02 03 03 03 03 07
01 03 03 07 08 06 08 08 09 03 03 15 01 01 01 10
01 01 02 10 06 06 13 13 14 03 03 01 01 01 01 12
01 01 03 12 13 14 03 03 03 03 03 15 03 03 00 00
01 03 03 03 03 03 03 03 15 03 03 03 03 03 00 00
